application_for,open_date_year,response_rate_met,ballots_in_favour,ballots_opposed,ballots_returned,ballots_distributed,poll_result
Front Yard Parking,2015,Yes,16,1,17,34,In Favour
Front Yard Parking,2015,Yes,30,0,30,36,In Favour
Front Yard Parking,2015,Yes,37,3,40,97,In Favour
Traffic Calming,2015,No,101,31,132,334,Response Rate Not Met
Boulevard Cafe,2015,Yes,19,10,29,106,In Favour
Traffic Calming,2015,No,42,20,62,235,Response Rate Not Met
Commercial Boulevard Parking,2015,No,13,11,24,235,Response Rate Not Met
Appeal - Front Yard Parking,2015,Yes,29,1,30,109,In Favour
Traffic Calming,2015,No,44,27,71,340,Response Rate Not Met
Front Yard Parking,2015,Yes,44,3,47,80,In Favour
Front Yard Parking,2015,Yes,32,0,32,73,In Favour
Traffic Calming,2015,Yes,19,5,24,43,In Favour
Traffic Calming,2015,Yes,47,8,55,78,In Favour
Boulevard Cafe,2015,No,0,3,3,16,Response Rate Not Met
Traffic Calming,2015,Yes,43,10,53,90,In Favour
Traffic Calming,2015,Yes,63,13,76,138,In Favour
Traffic Calming,2015,Yes,99,33,132,271,In Favour
Traffic Calming,2015,No,63,23,86,261,Response Rate Not Met
Traffic Calming,2015,Yes,44,17,61,138,In Favour
Boulevard Cafe,2015,No,1,0,1,24,Response Rate Not Met
Traffic Calming,2015,No,1,1,2,11,Response Rate Not Met
Boulevard Cafe,2015,No,18,11,29,151,Response Rate Not Met
Boulevard Cafe,2015,Yes,21,1,22,92,In Favour
Boulevard Cafe,2015,Yes,23,1,24,76,In Favour
Boulevard Cafe,2015,Yes,45,3,48,146,In Favour
Appeal - Front Yard Parking,2015,Yes,23,0,23,59,In Favour
Appeal - Front Yard Parking,2015,Yes,11,16,27,75,Opposed
Appeal - Front Yard Parking,2015,Yes,34,2,36,87,In Favour
Appeal - Front Yard Parking,2015,Yes,37,1,38,59,In Favour
Appeal - Front Yard Parking,2015,Yes,21,4,25,65,In Favour
Appeal - Front Yard Parking,2015,Yes,31,16,47,113,In Favour
Boulevard Cafe,2015,No,0,0,0,22,Response Rate Not Met
Traffic Calming,2015,No,18,18,36,100,Response Rate Not Met
Traffic Calming,2015,Yes,22,9,31,54,In Favour
Front Yard Parking,2015,Yes,16,0,16,29,In Favour
Boulevard Cafe,2015,Yes,10,8,18,66,Opposed
Boulevard Cafe,2015,No,0,0,0,18,Response Rate Not Met
Boulevard Cafe,2015,Yes,32,1,33,43,In Favour
Appeal - Front Yard Parking,2015,Yes,4,23,27,67,Opposed
Appeal - Front Yard Parking,2015,Yes,20,0,20,40,In Favour
Appeal - Front Yard Parking,2015,Yes,33,5,38,84,In Favour
Appeal - Front Yard Parking,2015,Yes,32,10,42,127,In Favour
Traffic Calming,2015,No,30,5,35,86,Response Rate Not Met
Appeal - Front Yard Parking,2015,Yes,20,2,22,101,In Favour
Appeal - Front Yard Parking,2015,Yes,20,2,22,56,In Favour
Appeal - Front Yard Parking,2015,Yes,24,2,26,30,In Favour
Appeal - Front Yard Parking,2015,Yes,45,2,47,77,In Favour
Front Yard Parking,2015,Yes,20,2,22,94,In Favour
Boulevard Cafe,2015,Yes,20,6,26,98,In Favour
Boulevard Cafe,2015,Yes,1,28,29,65,Opposed
Appeal - Front Yard Parking,2015,Yes,35,3,38,99,In Favour
Appeal - Front Yard Parking,2015,Yes,12,4,16,34,In Favour
Traffic Calming,2015,No,5,1,6,56,Response Rate Not Met
Traffic Calming,2015,No,19,18,37,106,Response Rate Not Met
Boulevard Cafe,2015,Yes,57,38,95,315,In Favour
Traffic Calming,2015,Yes,170,40,210,358,In Favour
Front Yard Parking,2015,Yes,46,4,50,97,In Favour
Traffic Calming,2015,No,19,15,34,86,Response Rate Not Met
Traffic Calming,2015,Yes,28,15,43,69,In Favour
Traffic Calming,2015,Yes,31,25,56,75,Opposed
Boulevard Cafe,2015,No,14,7,21,134,Response Rate Not Met
Front Yard Parking,2015,Yes,14,7,21,53,In Favour
Front Yard Parking,2015,Yes,14,5,19,51,In Favour
Traffic Calming,2015,No,60,18,78,314,Response Rate Not Met
Appeal - Front Yard Parking,2015,Yes,42,5,47,154,In Favour
Appeal - Front Yard Parking,2015,Yes,48,12,60,107,In Favour
Front Yard Parking,2015,Yes,14,0,14,41,In Favour
Appeal - Front Yard Parking,2015,Yes,30,15,45,74,In Favour
Appeal - Front Yard Parking,2015,Yes,38,33,71,148,Opposed
Appeal - Front Yard Parking,2015,Yes,58,0,58,97,In Favour
Proposed Business Improvement Area,2015,Yes,11,3,14,36,In Favour
Permit Parking,2015,Yes,5,3,8,11,In Favour
Boulevard Cafe,2015,Yes,11,21,32,93,Opposed
Appeal - Front Yard Parking,2015,Yes,30,14,44,101,In Favour
Appeal - Front Yard Parking,2015,Yes,48,2,50,111,In Favour
Appeal - Front Yard Parking,2015,Yes,13,0,13,46,In Favour
Appeal - Front Yard Parking,2015,Yes,26,0,26,35,In Favour
Appeal - Front Yard Parking,2015,Yes,67,0,67,115,In Favour
Appeal - Front Yard Parking,2015,Yes,29,8,37,123,In Favour
Appeal - Front Yard Parking,2015,Yes,8,4,12,35,In Favour
Front Yard Parking,2015,Yes,15,6,21,33,In Favour
Front Yard Parking,2015,Yes,21,0,21,32,In Favour
Front Yard Parking,2015,Yes,20,0,20,52,In Favour
Front Yard Parking,2015,Yes,19,1,20,38,In Favour
Traffic Calming,2015,No,119,21,140,319,Response Rate Not Met
Permit Parking,2015,No,28,28,56,294,Response Rate Not Met
Appeal - Front Yard Parking,2015,Yes,23,0,23,49,In Favour
Front Yard Parking,2015,Yes,20,0,20,68,In Favour
Appeal - Front Yard Parking,2015,Yes,33,7,40,95,In Favour
Front Yard Parking,2015,Yes,45,0,45,74,In Favour
Front Yard Parking,2015,Yes,36,0,36,78,In Favour
Appeal - Front Yard Parking,2015,Yes,28,3,31,85,In Favour
Commercial Boulevard Parking,2015,No,5,5,10,86,Response Rate Not Met
Commercial Boulevard Parking,2015,Yes,5,6,11,28,Opposed
Commercial Boulevard Parking,2015,No,4,6,10,85,Response Rate Not Met
Front Yard Parking,2015,Yes,39,7,46,103,In Favour
Front Yard Parking,2015,Yes,12,0,12,28,In Favour
Front Yard Parking,2015,Yes,30,1,31,114,In Favour
Front Yard Parking,2015,Yes,21,3,24,65,In Favour
Front Yard Parking,2015,No,25,8,33,153,Response Rate Not Met
Front Yard Parking,2015,Yes,50,0,50,102,In Favour
Traffic Calming,2015,No,59,11,70,205,Response Rate Not Met
Front Yard Parking,2015,Yes,54,2,56,100,In Favour
Front Yard Parking,2015,Yes,45,0,45,100,In Favour
Front Yard Parking,2015,Yes,16,0,16,39,In Favour
Front Yard Parking,2015,Yes,39,6,45,144,In Favour
Front Yard Parking,2015,Yes,21,0,21,46,In Favour
Front Yard Parking,2015,Yes,24,0,24,37,In Favour
Appeal - Front Yard Parking,2015,Yes,19,3,22,29,In Favour
Appeal - Front Yard Parking,2015,Yes,23,6,29,84,In Favour
Appeal - Front Yard Parking,2015,Yes,6,17,23,48,Opposed
Appeal - Front Yard Parking,2015,Yes,43,10,53,147,In Favour
Appeal - Front Yard Parking,2015,Yes,14,0,14,47,In Favour
Appeal - Front Yard Parking,2015,Yes,19,0,19,42,In Favour
Proposed Business Improvement Area,2015,Yes,18,2,20,62,In Favour
Traffic Calming,2015,No,201,40,241,1637,Response Rate Not Met
Traffic Calming,2015,No,44,77,121,451,Response Rate Not Met
Front Yard Parking,2015,Yes,28,0,28,50,In Favour
Front Yard Parking,2015,Yes,31,0,31,91,In Favour
Front Yard Parking,2015,Yes,26,10,36,146,In Favour
Appeal - Front Yard Parking,2015,Yes,25,3,28,60,In Favour
Traffic Calming,2015,No,194,146,340,1312,Response Rate Not Met
Traffic Calming,2015,No,68,27,95,764,Response Rate Not Met
Traffic Calming,2015,No,24,5,29,83,Response Rate Not Met
Traffic Calming,2015,Yes,18,3,21,34,In Favour
Front Yard Parking,2015,Yes,32,0,32,62,In Favour
Front Yard Parking,2015,Yes,35,1,36,79,In Favour
Traffic Calming,2015,No,78,28,106,270,Response Rate Not Met
Boulevard Cafe,2015,Yes,1,35,36,81,Opposed
Traffic Calming,2016,Yes,103,84,187,305,Opposed
Traffic Calming,2016,Yes,96,16,112,189,In Favour
Traffic Calming,2016,Yes,84,101,185,297,Opposed
Traffic Calming,2015,No,178,94,272,1652,Response Rate Not Met
Traffic Calming,2015,Yes,34,10,44,87,In Favour
Boulevard Cafe,2015,No,3,1,4,82,Response Rate Not Met
Permit Parking,2015,Yes,9,13,22,53,Opposed
Traffic Calming,2016,Yes,37,22,59,106,Opposed
Appeal - Front Yard Parking,2016,Yes,22,0,22,77,In Favour
Front Yard Parking,2016,Yes,41,0,41,87,In Favour
Front Yard Parking,2016,Yes,38,2,40,105,In Favour
Front Yard Parking,2016,Yes,7,4,11,22,In Favour
Appeal - Front Yard Parking,2016,Yes,26,4,30,81,In Favour
Appeal - Front Yard Parking,2016,Yes,24,2,26,110,In Favour
Appeal - Front Yard Parking,2016,Yes,44,13,57,141,In Favour
Appeal - Front Yard Parking,2016,Yes,27,2,29,88,In Favour
Permit Parking,2016,No,10,11,21,101,Response Rate Not Met
Permit Parking,2016,Yes,22,26,48,90,Opposed
Permit Parking,2016,Yes,13,23,36,89,Opposed
Front Yard Parking,2016,Yes,42,0,42,84,In Favour
Front Yard Parking,2016,Yes,28,1,29,46,In Favour
Appeal - Front Yard Parking,2016,Yes,26,13,39,130,In Favour
Traffic Calming,2016,Yes,35,14,49,87,In Favour
Appeal - Front Yard Parking,2016,Yes,22,1,23,58,In Favour
Appeal - Front Yard Parking,2016,Yes,13,0,13,21,In Favour
Appeal - Front Yard Parking,2016,Yes,17,0,17,26,In Favour
Appeal - Front Yard Parking,2016,Yes,25,7,32,62,In Favour
Front Yard Parking,2016,Yes,57,10,67,140,In Favour
Appeal - Front Yard Parking,2016,Yes,33,1,34,85,In Favour
Appeal - Front Yard Parking,2016,Yes,16,1,17,62,In Favour
Permit Parking,2016,Yes,10,14,24,60,Opposed
Front Yard Parking,2016,Yes,37,4,41,117,In Favour
Front Yard Parking,2016,Yes,45,18,63,125,In Favour
Front Yard Parking,2016,Yes,35,0,35,109,In Favour
Appeal - Front Yard Parking,2016,Yes,40,2,42,77,In Favour
Traffic Calming,2016,No,49,9,58,130,Response Rate Not Met
Boulevard Cafe,2016,Yes,36,17,53,114,In Favour
Appeal - Front Yard Parking,2016,Yes,38,20,58,131,In Favour
Appeal - Front Yard Parking,2016,Yes,17,1,18,53,In Favour
Appeal - Front Yard Parking,2016,Yes,25,21,46,136,In Favour
Appeal - Front Yard Parking,2016,Yes,18,7,25,61,In Favour
Appeal - Front Yard Parking,2016,Yes,26,14,40,108,In Favour
Appeal - Front Yard Parking,2016,Yes,32,3,35,116,In Favour
Front Yard Parking,2016,Yes,44,2,46,79,In Favour
Permit Parking,2016,Yes,0,9,9,23,Opposed
Permit Parking,2016,Yes,36,16,52,150,In Favour
Traffic Calming,2016,No,36,12,48,138,Response Rate Not Met
Appeal - Front Yard Parking,2016,Yes,21,3,24,69,In Favour
Permit Parking,2016,No,133,79,212,1847,Response Rate Not Met
Traffic Calming,2016,No,17,25,42,143,Response Rate Not Met
Traffic Calming,2016,No,66,38,104,495,Response Rate Not Met
Front Yard Parking,2016,Yes,14,0,14,23,In Favour
Traffic Calming,2016,No,536,382,918,2424,Response Rate Not Met
Front Yard Parking,2016,Yes,81,1,82,159,In Favour
Commercial Boulevard Parking,2016,No,1,3,4,45,Response Rate Not Met
Commercial Boulevard Parking,2016,No,0,0,0,46,Response Rate Not Met
Front Yard Parking,2016,Yes,43,2,45,82,In Favour
Front Yard Parking,2016,Yes,39,5,44,73,In Favour
Boulevard Cafe,2016,No,3,5,8,51,Response Rate Not Met
Appeal - Front Yard Parking,2016,Yes,27,25,52,117,Opposed
Boulevard Cafe,2016,Yes,37,15,52,99,In Favour
Appeal - Front Yard Parking,2016,Yes,32,11,43,115,In Favour
Appeal - Front Yard Parking,2016,Yes,27,18,45,145,In Favour
Front Yard Parking,2016,Yes,25,3,28,68,In Favour
Boulevard Cafe,2016,No,14,5,19,129,Response Rate Not Met
Traffic Calming,2016,No,46,2,48,116,Response Rate Not Met
Appeal - Front Yard Parking,2016,Yes,6,26,32,58,Opposed
Front Yard Parking,2016,Yes,14,0,14,28,In Favour
Appeal - Front Yard Parking,2016,Yes,87,2,89,253,In Favour
Appeal - Front Yard Parking,2016,Yes,53,9,62,151,In Favour
Boulevard Cafe,2016,No,6,3,9,95,Response Rate Not Met
Traffic Calming – Island,2016,No,16,2,18,63,Response Rate Not Met
Front Yard Parking,2016,Yes,34,6,40,83,In Favour
Appeal - Front Yard Parking,2016,Yes,8,15,23,37,Opposed
Appeal - Front Yard Parking,2016,Yes,23,10,33,138,In Favour
Appeal - Front Yard Parking,2016,Yes,12,31,43,80,Opposed
Appeal - Front Yard Parking,2016,Yes,24,10,34,85,In Favour
Front Yard Parking,2016,Yes,46,4,50,86,In Favour
Front Yard Parking,2016,Yes,54,2,56,96,In Favour
Boulevard Cafe,2016,Yes,17,19,36,131,Opposed
Appeal - Front Yard Parking,2016,Yes,11,4,15,66,In Favour
Boulevard Cafe,2016,No,12,0,12,104,Response Rate Not Met
Boulevard Cafe,2016,Yes,8,19,27,76,Opposed
Boulevard Cafe,2016,Yes,9,1,10,44,In Favour
Proposed Business Improvement Area,2016,Yes,6,2,8,29,In Favour
Front Yard Parking,2016,Yes,25,5,30,61,In Favour
Front Yard Parking,2016,Yes,52,4,56,126,In Favour
Appeal - Front Yard Parking,2016,Yes,21,8,29,98,In Favour
Traffic Calming,2016,Yes,12,3,15,25,In Favour
Boulevard Cafe,2016,No,2,0,2,39,Response Rate Not Met
Traffic Calming,2016,No,21,4,25,51,Response Rate Not Met
Front Yard Parking,2016,Yes,51,0,51,153,In Favour
Appeal - Front Yard Parking,2016,Yes,24,6,30,69,In Favour
Appeal - Front Yard Parking,2016,Yes,14,0,14,51,In Favour
Appeal - Front Yard Parking,2016,Yes,61,6,67,149,In Favour
Appeal - Front Yard Parking,2016,Yes,64,5,69,117,In Favour
Appeal - Front Yard Parking,2016,Yes,67,5,72,117,In Favour
Boulevard Cafe,2016,Yes,4,19,23,63,Opposed
Traffic Calming,2016,No,53,15,68,166,Response Rate Not Met
Front Yard Parking,2016,Yes,57,7,64,212,In Favour
Traffic Calming,2016,Yes,50,30,80,140,Opposed
Traffic Calming,2016,Yes,32,2,34,63,In Favour
Front Yard Parking,2016,Yes,33,4,37,67,In Favour
Appeal - Front Yard Parking,2016,Yes,21,2,23,51,In Favour
Appeal - Front Yard Parking,2016,Yes,44,5,49,89,In Favour
Front Yard Parking,2016,Yes,20,2,22,29,In Favour
Appeal - Front Yard Parking,2016,Yes,10,5,15,35,In Favour
Permit Parking,2016,Yes,2,0,2,6,Opposed
Traffic Calming,2016,No,18,7,25,116,Response Rate Not Met
Traffic Calming,2016,No,57,14,71,175,Response Rate Not Met
Front Yard Parking,2016,Yes,40,1,41,93,In Favour
Boulevard Cafe,2016,Yes,2,13,15,47,Opposed
Appeal - Front Yard Parking,2016,Yes,13,4,17,23,In Favour
Front Yard Parking,2016,Yes,41,1,42,45,In Favour
Boulevard Cafe,2016,Yes,38,18,56,143,In Favour
Boulevard Cafe,2016,No,14,13,27,149,Response Rate Not Met
Boulevard Cafe,2016,Yes,6,0,6,34,In Favour
Boulevard Cafe,2016,Yes,16,2,18,71,In Favour
Appeal - Front Yard Parking,2016,Yes,31,0,31,95,In Favour
Front Yard Parking,2016,Yes,85,2,87,119,In Favour
Front Yard Parking,2016,Yes,26,23,49,114,Opposed
Appeal - Front Yard Parking,2016,Yes,37,7,44,70,In Favour
Front Yard Parking,2016,Yes,34,2,36,110,In Favour
Front Yard Parking,2016,Yes,46,1,47,76,In Favour
Front Yard Parking,2016,Yes,54,14,68,130,In Favour
Boulevard Cafe,2016,Yes,5,5,10,44,Opposed
Front Yard Parking,2016,Yes,10,2,12,23,In Favour
Traffic Calming,2016,Yes,19,22,41,72,Opposed
Traffic Calming,2016,Yes,24,9,33,64,In Favour
Boulevard Cafe,2016,Yes,2,5,7,13,Opposed
Traffic Calming,2016,No,5,6,11,30,Response Rate Not Met
Traffic Calming,2016,Yes,43,27,70,116,Opposed
Traffic Calming,2016,No,46,28,74,319,Response Rate Not Met
Traffic Calming,2016,Yes,61,24,85,188,In Favour
Traffic Calming,2016,No,25,0,25,64,Response Rate Not Met
Front Yard Parking,2016,Yes,39,5,44,103,In Favour
Front Yard Parking,2016,Yes,35,1,36,70,In Favour
Appeal - Front Yard Parking,2016,Yes,30,0,30,48,In Favour
Appeal - Front Yard Parking,2016,Yes,46,22,68,133,In Favour
Front Yard Parking,2016,Yes,38,2,40,78,In Favour
Appeal - Front Yard Parking,2016,Yes,74,8,82,194,In Favour
Front Yard Parking,2016,Yes,26,0,26,44,In Favour
Appeal - Front Yard Parking,2016,Yes,6,1,7,15,In Favour
Front Yard Parking,2016,Yes,32,1,33,46,In Favour
Boulevard Cafe,2016,No,7,13,20,127,Response Rate Not Met
Traffic Calming,2016,No,138,48,186,461,Response Rate Not Met
Boulevard Cafe,2016,No,1,2,3,14,Response Rate Not Met
Boulevard Cafe,2016,Yes,2,25,27,115,Opposed
Boulevard Cafe,2016,Yes,25,11,36,118,In Favour
Boulevard Cafe,2016,Yes,17,5,22,114,In Favour
Boulevard Cafe,2016,Yes,23,0,23,66,In Favour
Boulevard Cafe,2016,No,0,0,0,5,Response Rate Not Met
Appeal - Front Yard Parking,2016,Yes,17,9,26,71,In Favour
Traffic Calming,2016,No,76,24,100,225,Response Rate Not Met
Appeal - Front Yard Parking,2016,Yes,60,0,60,116,In Favour
Appeal - Front Yard Parking,2016,Yes,35,6,41,125,In Favour
Front Yard Parking,2016,Yes,10,0,10,12,In Favour
Front Yard Parking,2016,Yes,22,1,23,40,In Favour
Appeal - Front Yard Parking,2016,Yes,22,8,30,81,In Favour
Front Yard Parking,2016,Yes,48,0,48,88,In Favour
Front Yard Parking,2016,Yes,27,1,28,41,In Favour
Front Yard Parking,2016,Yes,30,7,37,64,In Favour
Front Yard Parking,2016,Yes,41,1,42,96,In Favour
Appeal - Front Yard Parking,2016,Yes,27,0,27,112,In Favour
Appeal - Front Yard Parking,2016,Yes,48,5,53,117,In Favour
Front Yard Parking,2016,Yes,65,3,68,136,In Favour
Front Yard Parking,2016,Yes,44,1,45,83,In Favour
Appeal - Front Yard Parking,2016,Yes,31,2,33,84,In Favour
Appeal - Front Yard Parking,2016,Yes,30,4,34,85,In Favour
Appeal - Front Yard Parking,2016,No,16,5,21,140,Response Rate Not Met
Traffic Calming,2016,Yes,22,4,26,31,In Favour
Front Yard Parking,2016,Yes,55,0,55,74,In Favour
Front Yard Parking,2016,Yes,47,0,47,106,In Favour
Appeal - Front Yard Parking,2016,Yes,49,4,53,153,In Favour
Appeal - Front Yard Parking,2016,Yes,31,2,33,106,In Favour
Traffic Calming – Island,2016,Yes,15,10,25,30,Opposed
Front Yard Parking,2016,Yes,13,0,13,50,In Favour
Front Yard Parking,2016,Yes,21,1,22,93,In Favour
Boulevard Cafe,2016,Yes,4,6,10,20,Opposed
Traffic Calming,2016,No,170,39,209,569,Response Rate Not Met
Appeal - Front Yard Parking,2016,Yes,36,3,39,92,In Favour
Appeal - Front Yard Parking,2016,Yes,30,6,36,73,In Favour
Appeal - Front Yard Parking,2016,Yes,24,17,41,136,In Favour
Appeal - Front Yard Parking,2016,Yes,22,0,22,40,In Favour
Appeal - Front Yard Parking,2016,Yes,32,8,40,121,In Favour
Appeal - Front Yard Parking,2016,Yes,29,7,36,109,In Favour
Appeal - Front Yard Parking,2016,Yes,27,5,32,70,In Favour
Appeal - Front Yard Parking,2016,Yes,27,13,40,130,In Favour
Appeal - Front Yard Parking,2016,Yes,32,16,48,130,In Favour
Appeal - Front Yard Parking,2016,Yes,19,1,20,47,In Favour
Boulevard Cafe,2016,No,17,4,21,162,Response Rate Not Met
Front Yard Parking,2016,Yes,43,1,44,70,In Favour
Permit Parking,2016,No,2,3,5,31,Response Rate Not Met
Front Yard Parking,2016,Yes,41,6,47,105,In Favour
Appeal - Front Yard Parking,2016,Yes,23,20,43,90,Opposed
Front Yard Parking,2016,Yes,38,0,38,83,In Favour
Front Yard Parking,2016,Yes,29,4,33,59,In Favour
Front Yard Parking,2016,Yes,31,4,35,82,In Favour
Front Yard Parking,2016,Yes,25,1,26,83,In Favour
Front Yard Parking,2016,Yes,26,1,27,53,In Favour
Appeal - Front Yard Parking,2016,Yes,55,5,60,135,In Favour
Appeal - Front Yard Parking,2016,Yes,38,0,38,92,In Favour
Appeal - Front Yard Parking,2016,Yes,45,0,45,70,In Favour
Appeal - Front Yard Parking,2016,Yes,18,12,30,93,Opposed
Commercial Boulevard Parking,2016,Yes,11,11,22,64,Opposed
Front Yard Parking,2016,Yes,13,23,36,104,Opposed
Front Yard Parking,2016,Yes,52,10,62,156,In Favour
Front Yard Parking,2016,Yes,28,6,34,74,In Favour
Front Yard Parking,2016,Yes,54,0,54,109,In Favour
Boulevard Cafe,2016,No,13,0,13,99,Response Rate Not Met
Appeal - Front Yard Parking,2016,Yes,41,4,45,78,In Favour
Appeal - Front Yard Parking,2016,Yes,42,4,46,83,In Favour
Front Yard Parking,2016,Yes,10,0,10,20,In Favour
Front Yard Parking,2016,Yes,29,2,31,47,In Favour
Front Yard Parking,2016,Yes,26,0,26,42,In Favour
Commercial Boulevard Parking,2016,No,3,0,3,24,Response Rate Not Met
Front Yard Parking,2016,Yes,35,0,35,97,In Favour
Front Yard Parking,2016,Yes,7,0,7,19,In Favour
Front Yard Parking,2016,Yes,31,0,31,38,In Favour
Front Yard Parking,2016,Yes,55,8,63,102,In Favour
Traffic Calming,2016,Yes,19,8,27,55,In Favour
Traffic Calming,2016,No,41,25,66,163,Response Rate Not Met
Appeal - Front Yard Parking,2016,Yes,31,1,32,42,In Favour
Appeal - Front Yard Parking,2016,Yes,20,4,24,97,In Favour
Appeal - Front Yard Parking,2016,Yes,12,17,29,65,Opposed
Appeal - Front Yard Parking,2016,Yes,12,4,16,38,In Favour
Appeal - Front Yard Parking,2016,Yes,30,2,32,66,In Favour
Appeal - Front Yard Parking,2016,Yes,50,0,50,96,In Favour
Appeal - Front Yard Parking,2016,Yes,22,27,49,135,Opposed
Appeal - Front Yard Parking,2016,Yes,12,9,21,70,Opposed
Front Yard Parking,2016,Yes,40,1,41,107,In Favour
Front Yard Parking,2016,Yes,41,0,41,65,In Favour
Front Yard Parking,2016,Yes,24,0,24,39,In Favour
Permit Parking,2017,Yes,16,17,33,140,Opposed
Boulevard Cafe,2017,Yes,15,7,22,92,In Favour
Permit Parking,2016,Yes,44,8,52,205,In Favour
Permit Parking,2017,Yes,7,3,10,22,In Favour
Front Yard Parking,2016,Yes,29,0,29,76,In Favour
Boulevard Cafe,2017,Yes,25,10,35,65,In Favour
Front Yard Parking,2017,Yes,13,1,14,54,In Favour
Front Yard Parking,2017,Yes,25,1,26,60,In Favour
Front Yard Parking,2017,Yes,33,2,35,50,In Favour
Front Yard Parking,2017,Yes,36,4,40,133,In Favour
Front Yard Parking,2017,Yes,4,0,4,11,In Favour
Front Yard Parking,2017,Yes,24,0,24,40,In Favour
Permit Parking,2017,Yes,12,11,23,61,Opposed
Permit Parking,2017,Yes,16,47,63,121,Opposed
Appeal - Front Yard Parking,2017,Yes,31,2,33,107,In Favour
Front Yard Parking,2017,Yes,54,0,54,97,In Favour
Front Yard Parking,2017,Yes,13,0,13,41,In Favour
Front Yard Parking,2017,Yes,34,0,34,74,In Favour
Appeal - Front Yard Parking,2017,Yes,4,16,20,37,Opposed
Front Yard Parking,2017,Yes,22,1,23,31,In Favour
Permit Parking,2017,Yes,6,7,13,21,Opposed
Permit Parking,2017,Yes,32,25,57,167,In Favour
Permit Parking,2017,Yes,8,26,34,57,Opposed
Front Yard Parking,2017,Yes,35,14,49,111,In Favour
Appeal - Front Yard Parking,2017,Yes,53,0,53,79,In Favour
Front Yard Parking,2017,Yes,50,2,52,100,In Favour
Front Yard Parking,2017,Yes,57,0,57,102,In Favour
Appeal - Front Yard Parking,2017,Yes,66,5,71,185,In Favour
Appeal - Front Yard Parking,2017,Yes,24,0,24,79,In Favour
Front Yard Parking,2017,Yes,40,0,40,116,In Favour
Appeal - Front Yard Parking,2017,Yes,53,3,56,165,In Favour
Appeal - Front Yard Parking,2017,Yes,40,7,47,130,In Favour
Appeal - Front Yard Parking,2017,Yes,59,21,80,138,In Favour
Boulevard Cafe,2017,Yes,2,1,3,14,Opposed
Boulevard Cafe,2017,Yes,7,28,35,87,Opposed
Front Yard Parking,2017,Yes,29,11,40,99,In Favour
Front Yard Parking,2017,Yes,12,0,12,26,In Favour
Front Yard Parking,2017,Yes,43,2,45,115,In Favour
Front Yard Parking,2017,Yes,30,0,30,96,In Favour
Front Yard Parking,2017,Yes,21,0,21,40,In Favour
Front Yard Parking,2017,Yes,25,0,25,64,In Favour
Front Yard Parking,2017,Yes,29,8,37,98,In Favour
Front Yard Parking,2017,Yes,36,6,42,94,In Favour
Front Yard Parking,2017,Yes,15,0,15,34,In Favour
Appeal - Front Yard Parking,2017,Yes,41,2,43,116,In Favour
Appeal - Front Yard Parking,2017,Yes,34,5,39,111,In Favour
Appeal - Front Yard Parking,2017,Yes,17,2,19,70,In Favour
Permit Parking,2017,Yes,15,8,23,48,In Favour
Front Yard Parking,2017,Yes,12,0,12,18,In Favour
Appeal - Front Yard Parking,2017,Yes,8,2,10,44,In Favour
Traffic Calming,2017,Yes,6,7,13,21,Opposed
Traffic Calming,2017,No,63,30,93,238,Response Rate Not Met
Traffic Calming,2017,No,25,2,27,84,Response Rate Not Met
Boulevard Cafe,2017,Yes,13,0,13,39,In Favour
Front Yard Parking,2017,Yes,33,2,35,106,In Favour
Front Yard Parking,2017,Yes,17,0,17,46,In Favour
Front Yard Parking,2017,Yes,37,8,45,75,In Favour
Traffic Calming,2017,No,56,6,62,160,Response Rate Not Met
Front Yard Parking,2017,Yes,31,2,33,88,In Favour
Front Yard Parking,2017,Yes,35,0,35,75,In Favour
Appeal - Front Yard Parking,2017,Yes,20,4,24,77,In Favour
Front Yard Parking,2017,Yes,44,10,54,120,In Favour
Boulevard Cafe,2017,No,1,5,6,49,Response Rate Not Met
Boulevard Cafe,2017,No,4,1,5,38,Response Rate Not Met
Traffic Calming,2017,Yes,30,21,51,89,Opposed
Traffic Calming,2017,No,86,23,109,271,Response Rate Not Met
Traffic Calming,2017,Yes,54,19,73,132,In Favour
Front Yard Parking,2017,Yes,43,7,50,89,In Favour
Appeal - Front Yard Parking,2017,Yes,28,3,31,103,In Favour
Appeal - Front Yard Parking,2017,Yes,6,0,6,21,In Favour
Appeal - Front Yard Parking,2017,Yes,19,33,52,122,Opposed
Appeal - Front Yard Parking,2017,Yes,23,8,31,120,In Favour
Appeal - Front Yard Parking,2017,Yes,10,20,30,49,Opposed
Appeal - Front Yard Parking,2017,Yes,18,3,21,51,In Favour
Appeal - Front Yard Parking,2017,Yes,40,10,50,142,In Favour
Appeal - Front Yard Parking,2017,Yes,30,1,31,63,In Favour
Appeal - Front Yard Parking,2017,Yes,11,0,11,28,In Favour
Appeal - Front Yard Parking,2017,Yes,55,7,62,129,In Favour
Front Yard Parking,2017,Yes,49,4,53,93,In Favour
Front Yard Parking,2017,Yes,39,0,39,128,In Favour
Front Yard Parking,2017,Yes,32,4,36,120,In Favour
Appeal - Front Yard Parking,2017,Yes,26,2,28,68,In Favour
Traffic Calming,2017,No,46,32,78,194,Response Rate Not Met
Front Yard Parking,2017,Yes,16,2,18,88,In Favour
Front Yard Parking,2017,Yes,29,2,31,54,In Favour
Front Yard Parking,2017,Yes,13,8,21,54,Opposed
Traffic Calming,2017,No,303,161,464,1258,Response Rate Not Met
Traffic Calming,2017,Yes,14,3,17,31,In Favour
Traffic Calming,2017,Yes,27,7,34,67,In Favour
Front Yard Parking,2017,Yes,20,7,27,129,In Favour
Boulevard Cafe,2017,No,5,1,6,39,Response Rate Not Met
Appeal - Front Yard Parking,2017,Yes,27,12,39,119,In Favour
Boulevard Cafe,2017,Yes,14,29,43,117,Opposed
Boulevard Cafe,2017,Yes,8,3,11,26,In Favour
Boulevard Cafe,2017,Yes,16,5,21,93,In Favour
Boulevard Cafe,2017,No,4,18,22,137,Response Rate Not Met
Boulevard Cafe,2017,Yes,9,0,9,27,In Favour
Traffic Calming,2017,Yes,88,40,128,279,In Favour
Boulevard Cafe,2017,No,6,0,6,57,Response Rate Not Met
Traffic Calming,2017,Yes,78,24,102,187,In Favour
Boulevard Cafe,2017,Yes,20,15,35,81,In Favour
Boulevard Cafe,2017,No,1,7,8,39,Response Rate Not Met
Traffic Calming,2017,No,75,21,96,265,Response Rate Not Met
Traffic Calming,2017,No,22,8,30,107,Response Rate Not Met
Traffic Calming,2017,No,44,7,51,120,Response Rate Not Met
Appeal - Front Yard Parking,2017,Yes,18,34,52,129,Opposed
Appeal - Front Yard Parking,2017,Yes,17,33,50,129,Opposed
Appeal - Front Yard Parking,2017,Yes,16,12,28,76,Opposed
Boulevard Cafe,2017,No,2,1,3,226,Response Rate Not Met
Boulevard Cafe,2017,No,5,9,14,114,Response Rate Not Met
Traffic Calming,2017,No,7,7,14,55,Response Rate Not Met
Front Yard Parking,2017,Yes,29,0,29,40,In Favour
Front Yard Parking,2017,Yes,17,9,26,45,In Favour
Permit Parking,2017,Yes,8,24,32,58,Opposed
Traffic Calming,2017,No,1,0,1,4,Response Rate Not Met
Permit Parking,2017,Yes,4,13,17,62,Opposed
Front Yard Parking,2017,Yes,8,30,38,68,Opposed
Traffic Calming,2017,Yes,71,26,97,188,In Favour
Traffic Calming,2017,No,66,11,77,198,Response Rate Not Met
Traffic Calming,2017,No,51,18,69,223,Response Rate Not Met
Traffic Calming,2017,Yes,44,7,51,109,In Favour
Boulevard Cafe,2017,Yes,23,8,31,98,In Favour
Traffic Calming,2017,No,18,7,25,55,Response Rate Not Met
Traffic Calming,2017,No,9,1,10,25,Response Rate Not Met
Traffic Calming,2017,Yes,20,3,23,42,In Favour
Traffic Calming,2017,Yes,25,3,28,41,In Favour
Front Yard Parking,2017,Yes,37,0,37,78,In Favour
Front Yard Parking,2017,Yes,17,5,22,57,In Favour
Front Yard Parking,2017,Yes,13,6,19,86,Opposed
Appeal - Front Yard Parking,2017,Yes,14,2,16,19,In Favour
Traffic Calming,2017,No,26,22,48,180,Response Rate Not Met
Permit Parking,2017,No,60,9,69,555,Response Rate Not Met
Front Yard Parking,2017,Yes,26,0,26,43,In Favour
Front Yard Parking,2017,Yes,32,9,41,124,In Favour
Appeal - Front Yard Parking,2017,Yes,27,1,28,96,In Favour
Appeal - Front Yard Parking,2017,Yes,19,38,57,146,Opposed
Appeal - Front Yard Parking,2017,Yes,42,10,52,127,In Favour
Appeal - Front Yard Parking,2017,Yes,39,5,44,70,In Favour
Appeal - Front Yard Parking,2017,Yes,15,14,29,73,Opposed
Appeal - Front Yard Parking,2017,Yes,16,19,35,83,Opposed
Proposed Business Improvement Area,2017,Yes,12,3,15,19,In Favour
Front Yard Parking,2017,Yes,12,2,14,50,In Favour
Boulevard Cafe,2017,No,5,28,33,160,Response Rate Not Met
Front Yard Parking,2017,Yes,29,1,30,62,In Favour
Front Yard Parking,2017,Yes,29,13,42,88,In Favour
Permit Parking,2017,No,0,6,6,54,Response Rate Not Met
Boulevard Cafe,2017,Yes,16,10,26,108,Opposed
Traffic Calming,2017,Yes,12,19,31,69,Opposed
Traffic Calming,2017,No,28,8,36,117,Response Rate Not Met
Front Yard Parking,2017,Yes,24,1,25,59,In Favour
Front Yard Parking,2017,Yes,33,2,35,90,In Favour
Traffic Calming – Island,2017,Yes,71,60,131,275,Opposed
Traffic Calming – Island,2017,Yes,81,141,222,396,Opposed
Boulevard Cafe,2017,No,1,1,2,32,Response Rate Not Met
Front Yard Parking,2017,Yes,13,11,24,70,In Favour
Appeal - Front Yard Parking,2017,Yes,7,24,31,71,Opposed
Appeal - Front Yard Parking,2017,Yes,25,1,26,56,In Favour
Front Yard Parking,2017,Yes,27,1,28,74,In Favour
Traffic Calming,2017,Yes,31,21,52,77,Opposed
Appeal - Front Yard Parking,2017,Yes,61,9,70,150,In Favour
Front Yard Parking,2017,Yes,16,1,17,45,In Favour
Traffic Calming,2017,No,21,0,21,402,Response Rate Not Met
Traffic Calming,2017,Yes,19,6,25,73,Opposed
Traffic Calming,2017,No,36,33,69,165,Response Rate Not Met
Traffic Calming,2017,Yes,14,3,17,42,In Favour
Business Improvement Area,2017,Yes,43,10,53,129,In Favour
Traffic Calming,2017,No,97,25,122,327,Response Rate Not Met
Front Yard Parking,2017,Yes,5,6,11,13,Opposed
Front Yard Parking,2017,Yes,38,8,46,100,In Favour
Traffic Calming,2017,No,29,23,52,121,Response Rate Not Met
Permit Parking,2017,Yes,16,6,22,89,In Favour
Boulevard Cafe,2017,Yes,14,3,17,67,In Favour
Boulevard Cafe,2017,No,39,1,40,218,Response Rate Not Met
Appeal - Front Yard Parking,2017,Yes,30,16,46,129,In Favour
Appeal - Front Yard Parking,2017,Yes,29,14,43,129,In Favour
Traffic Calming,2017,Yes,37,9,46,92,In Favour
Traffic Calming,2017,No,119,37,156,387,Response Rate Not Met
Traffic Calming,2017,Yes,43,11,54,75,In Favour
Traffic Calming,2017,Yes,32,23,55,115,Opposed
Traffic Calming,2017,Yes,18,15,33,65,Opposed
Boulevard Cafe,2017,Yes,30,7,37,154,In Favour
Front Yard Parking,2017,Yes,69,2,71,113,In Favour
Appeal - Front Yard Parking,2017,Yes,6,13,19,60,Opposed
Boulevard Cafe,2017,Yes,17,6,23,92,In Favour
Appeal - Front Yard Parking,2017,Yes,17,5,22,74,In Favour
Traffic Calming,2017,Yes,56,11,67,125,In Favour
Traffic Calming,2017,No,45,8,53,113,Response Rate Not Met
Traffic Calming,2017,Yes,34,24,58,107,Opposed
Traffic Calming,2017,No,3,0,3,10,Response Rate Not Met
Traffic Calming,2017,Yes,29,23,52,73,Opposed
Front Yard Parking,2017,No,5,0,5,28,Response Rate Not Met
Front Yard Parking,2017,Yes,45,0,45,79,In Favour
Traffic Calming,2017,No,43,16,59,235,Response Rate Not Met
Traffic Calming,2017,No,36,7,43,206,Response Rate Not Met
Traffic Calming,2017,Yes,17,12,29,89,Opposed
Traffic Calming,2017,Yes,43,11,54,95,In Favour
Front Yard Parking,2017,Yes,8,21,29,50,Opposed
Appeal - Front Yard Parking,2017,Yes,34,1,35,83,In Favour
Traffic Calming,2017,No,2,1,3,11,Response Rate Not Met
Traffic Calming,2017,No,9,0,9,42,Response Rate Not Met
Traffic Calming,2017,Yes,34,0,34,49,In Favour
Front Yard Parking,2017,Yes,36,2,38,92,In Favour
Front Yard Parking,2017,Yes,9,0,9,13,In Favour
Front Yard Parking,2017,Yes,38,5,43,98,In Favour
Appeal - Front Yard Parking,2017,Yes,29,6,35,145,In Favour
Boulevard Cafe,2017,Yes,12,4,16,54,In Favour
Appeal - Front Yard Parking,2018,Yes,30,5,35,151,In Favour
Appeal - Front Yard Parking,2018,Yes,46,2,48,96,In Favour
Front Yard Parking,2018,Yes,30,0,30,46,In Favour
Boulevard Cafe,2018,Yes,11,8,19,105,Opposed
Appeal - Front Yard Parking,2018,Yes,24,1,25,81,In Favour
Appeal - Front Yard Parking,2018,No,12,0,12,53,Response Rate Not Met
Front Yard Parking,2018,Yes,33,1,34,73,In Favour
Front Yard Parking,2018,Yes,26,3,29,68,In Favour
Front Yard Parking,2018,Yes,32,2,34,79,In Favour
Front Yard Parking,2018,Yes,19,0,19,30,In Favour
Permit Parking,2018,Yes,34,64,98,397,Opposed
Permit Parking,2018,No,3,17,20,178,Response Rate Not Met
Permit Parking,2018,No,8,32,40,264,Response Rate Not Met
Front Yard Parking,2018,Yes,33,0,33,64,In Favour
Front Yard Parking,2018,Yes,23,0,23,49,In Favour
Front Yard Parking,2018,Yes,21,0,21,56,In Favour
Appeal - Front Yard Parking,2018,Yes,21,15,36,56,In Favour
Appeal - Front Yard Parking,2018,Yes,24,0,24,73,In Favour
Appeal - Front Yard Parking,2018,Yes,37,5,42,62,In Favour
Appeal - Front Yard Parking,2018,No,22,9,31,165,Response Rate Not Met
Appeal - Front Yard Parking,2018,Yes,42,0,42,151,In Favour
Boulevard Cafe,2018,Yes,26,5,31,51,In Favour
Traffic Calming,2018,No,18,7,25,71,Response Rate Not Met
Traffic Calming,2018,No,15,14,29,119,Response Rate Not Met
Appeal - Front Yard Parking,2018,Yes,12,14,26,60,Opposed
Appeal - Front Yard Parking,2018,Yes,23,23,46,185,Opposed
Traffic Calming,2018,Yes,43,4,47,82,In Favour
Front Yard Parking,2018,Yes,14,3,17,38,In Favour
Front Yard Parking,2018,No,15,0,15,88,Response Rate Not Met
Traffic Calming,2018,No,61,12,73,616,Response Rate Not Met
Permit Parking,2018,No,13,8,21,95,Response Rate Not Met
Permit Parking,2018,Yes,23,33,56,234,Opposed
Traffic Calming,2018,Yes,31,5,36,69,In Favour
Traffic Calming,2018,Yes,96,21,117,192,In Favour
Appeal - Front Yard Parking,2018,Yes,31,4,35,62,In Favour
Appeal - Front Yard Parking,2018,Yes,31,3,34,62,In Favour
Appeal - Front Yard Parking,2018,Yes,11,0,11,11,In Favour
Appeal - Front Yard Parking,2018,Yes,43,8,51,76,In Favour
Appeal - Front Yard Parking,2018,Yes,42,12,54,106,In Favour
Appeal - Front Yard Parking,2018,Yes,13,0,13,13,In Favour
Front Yard Parking,2018,Yes,29,0,29,76,In Favour
Front Yard Parking,2018,Yes,33,4,37,107,In Favour
Front Yard Parking,2018,Yes,27,0,27,59,In Favour
Front Yard Parking,2018,Yes,24,5,29,46,In Favour
Front Yard Parking,2018,Yes,56,2,58,125,In Favour
Front Yard Parking,2018,Yes,39,0,39,71,In Favour
Proposed Business Improvement Area,2018,Yes,7,0,7,20,In Favour
Appeal - Front Yard Parking,2018,Yes,25,3,28,67,In Favour
Front Yard Parking,2018,Yes,14,17,31,78,Opposed
Appeal - Front Yard Parking,2018,Yes,23,23,46,106,Opposed
Appeal - Front Yard Parking,2018,Yes,13,30,43,84,Opposed
Appeal - Front Yard Parking,2018,Yes,37,0,37,59,In Favour
Front Yard Parking,2018,Yes,86,1,87,200,In Favour
Front Yard Parking,2018,Yes,33,4,37,183,In Favour
Front Yard Parking,2018,Yes,29,3,32,75,In Favour
Front Yard Parking,2018,Yes,28,0,28,128,In Favour
Traffic Calming,2018,No,53,50,103,343,Response Rate Not Met
Appeal - Front Yard Parking,2018,No,5,1,6,35,Response Rate Not Met
Traffic Calming,2018,No,51,54,105,335,Response Rate Not Met
Boulevard Cafe,2018,No,10,2,12,135,Response Rate Not Met
Permit Parking,2018,Yes,11,0,11,19,In Favour
Front Yard Parking,2018,Yes,28,0,28,58,In Favour
Front Yard Parking,2018,Yes,48,6,54,104,In Favour
Appeal - Front Yard Parking,2018,No,4,0,4,21,Response Rate Not Met
Appeal - Front Yard Parking,2018,Yes,8,1,9,42,In Favour
Front Yard Parking,2018,Yes,9,0,9,43,In Favour
Commercial Boulevard Parking,2018,Yes,11,8,19,63,In Favour
Traffic Calming,2018,Yes,23,10,33,55,In Favour
Appeal - Front Yard Parking,2018,Yes,28,15,43,86,In Favour
Front Yard Parking,2018,Yes,34,5,39,103,In Favour
Front Yard Parking,2018,Yes,43,5,48,104,In Favour
Traffic Calming,2018,Yes,107,16,123,202,In Favour
Appeal - Front Yard Parking,2018,Yes,22,1,23,75,In Favour
Appeal - Front Yard Parking,2018,Yes,31,0,31,64,In Favour
Boulevard Cafe,2018,No,20,9,29,184,Response Rate Not Met
Front Yard Parking,2018,Yes,8,0,8,16,In Favour
Traffic Calming,2018,Yes,72,14,86,136,In Favour
Appeal - Front Yard Parking,2018,Yes,32,0,32,56,In Favour
Front Yard Parking,2018,Yes,33,0,33,85,In Favour
Traffic Calming,2018,No,46,15,61,199,Response Rate Not Met
Appeal - Front Yard Parking,2018,Yes,23,27,50,75,Opposed
Appeal - Front Yard Parking,2018,Yes,31,2,33,74,In Favour
Front Yard Parking,2018,Yes,67,1,68,131,In Favour
Front Yard Parking,2018,Yes,31,6,37,145,Opposed
Traffic Calming,2018,Yes,49,4,53,104,In Favour
Traffic Calming,2018,Yes,74,15,89,157,In Favour
Boulevard Cafe,2018,Yes,40,3,43,159,In Favour
Boulevard Cafe,2018,No,12,10,22,204,Response Rate Not Met
Front Yard Parking,2018,Yes,31,0,31,55,In Favour
Front Yard Parking,2018,Yes,23,2,25,84,In Favour
Traffic Calming,2018,Yes,77,20,97,196,In Favour
Front Yard Parking,2018,Yes,16,11,27,60,In Favour
Front Yard Parking,2018,Yes,43,5,48,95,In Favour
Front Yard Parking,2018,Yes,28,2,30,64,In Favour
Front Yard Parking,2018,Yes,28,0,28,63,In Favour
Traffic Calming,2018,Yes,37,52,89,154,Opposed
Traffic Calming,2018,Yes,100,24,124,277,In Favour
Traffic Calming,2018,No,45,15,60,157,Response Rate Not Met
Traffic Calming,2018,No,0,0,0,3,Response Rate Not Met
Permit Parking,2018,Yes,46,9,55,94,In Favour
Front Yard Parking,2018,Yes,48,1,49,115,In Favour
Front Yard Parking,2018,Yes,35,3,38,84,In Favour
Boulevard Cafe,2018,No,15,13,28,323,Response Rate Not Met
Front Yard Parking,2018,Yes,33,1,34,76,In Favour
Front Yard Parking,2018,Yes,14,9,23,90,Opposed
Front Yard Parking,2018,Yes,35,0,35,92,In Favour
Front Yard Parking,2018,Yes,38,5,43,99,In Favour
Front Yard Parking,2018,Yes,39,1,40,117,In Favour
Boulevard Cafe,2018,Yes,5,35,40,66,Opposed
Boulevard Cafe,2018,No,19,3,22,154,Response Rate Not Met
Front Yard Parking,2018,Yes,40,4,44,112,In Favour
Boulevard Cafe,2018,Yes,38,3,41,125,In Favour
Front Yard Parking,2018,Yes,47,3,50,85,In Favour
Traffic Calming,2018,Yes,10,0,10,17,In Favour
Front Yard Parking,2018,Yes,46,0,46,117,In Favour
Front Yard Parking,2018,Yes,18,4,22,54,In Favour
Appeal - Front Yard Parking,2018,Yes,15,10,25,55,In Favour
Traffic Calming,2018,Yes,60,46,106,198,Opposed
Traffic Calming,2018,No,23,5,28,86,Response Rate Not Met
Traffic Calming,2018,No,51,10,61,204,Response Rate Not Met
Front Yard Parking,2018,Yes,35,8,43,86,In Favour
Front Yard Parking,2018,Yes,13,2,15,30,In Favour
Boulevard Cafe,2018,No,8,5,13,89,Response Rate Not Met
Traffic Calming,2018,Yes,39,7,46,80,In Favour
Traffic Calming,2018,No,148,41,189,878,Response Rate Not Met
Traffic Calming,2018,No,25,6,31,122,Response Rate Not Met
Traffic Calming,2018,Yes,125,30,155,282,In Favour
Traffic Calming,2018,No,137,22,159,652,Response Rate Not Met
Boulevard Cafe,2018,Yes,4,8,12,76,Opposed
Traffic Calming,2018,No,8,0,8,20,Response Rate Not Met
Traffic Calming,2018,No,28,5,33,73,Response Rate Not Met
Boulevard Cafe,2018,Yes,4,13,17,66,Opposed
Front Yard Parking,2018,Yes,19,16,35,53,Opposed
Front Yard Parking,2018,Yes,11,6,17,58,In Favour
Front Yard Parking,2018,Yes,28,0,28,100,In Favour
Appeal - Front Yard Parking,2018,Yes,26,0,26,67,In Favour
Boulevard Cafe,2018,No,18,10,28,219,Response Rate Not Met
Traffic Calming,2018,No,31,10,41,143,Response Rate Not Met
Business Improvement Area,2018,Yes,104,9,113,302,In Favour
Front Yard Parking,2018,Yes,40,1,41,111,In Favour
Front Yard Parking,2018,Yes,26,0,26,68,In Favour
Boulevard Cafe,2018,No,20,4,24,255,Response Rate Not Met
Traffic Calming,2018,No,60,10,70,254,Response Rate Not Met
Permit Parking,2018,Yes,44,23,67,164,In Favour
Boulevard Cafe,2018,Yes,13,2,15,62,In Favour
Front Yard Parking,2018,Yes,34,11,45,169,In Favour
Front Yard Parking,2018,Yes,21,0,21,42,In Favour
Front Yard Parking,2018,Yes,24,4,28,78,In Favour
Permit Parking,2018,Yes,18,4,22,54,In Favour
Permit Parking,2018,Yes,49,13,62,214,In Favour
Traffic Calming,2018,Yes,160,133,293,526,Opposed
Traffic Calming,2018,Yes,64,12,76,128,In Favour
Front Yard Parking,2018,Yes,38,0,38,121,In Favour
Front Yard Parking,2018,Yes,35,2,37,68,In Favour
Boulevard Cafe,2018,Yes,18,10,28,83,In Favour
Boulevard Cafe,2018,Yes,19,6,25,74,In Favour
Commercial Boulevard Parking,2018,Yes,2,6,8,18,Opposed
Front Yard Parking,2018,Yes,59,3,62,83,In Favour
Front Yard Parking,2018,Yes,30,1,31,59,In Favour
Front Yard Parking,2018,Yes,33,7,40,74,In Favour
Front Yard Parking,2018,Yes,22,7,29,68,In Favour
Front Yard Parking,2018,Yes,29,9,38,75,In Favour
Front Yard Parking,2018,Yes,10,1,11,16,In Favour
Front Yard Parking,2018,Yes,16,0,16,35,In Favour
Front Yard Parking,2018,Yes,31,8,39,97,In Favour
Front Yard Parking,2018,Yes,20,1,21,60,In Favour
Traffic Calming,2018,No,18,11,29,108,Response Rate Not Met
Traffic Calming,2018,No,0,0,0,5,Response Rate Not Met
Permit Parking,2018,Yes,8,16,24,56,Opposed
Front Yard Parking,2018,Yes,16,6,22,68,In Favour
Front Yard Parking,2018,Yes,25,13,38,90,In Favour
Front Yard Parking,2018,Yes,23,2,25,81,In Favour
Boulevard Cafe,2019,Yes,20,0,20,34,In Favour
Front Yard Parking,2019,Yes,30,0,30,61,In Favour
Commercial Boulevard Parking,2019,Yes,4,9,13,31,Opposed
Front Yard Parking,2019,Yes,21,0,21,49,In Favour
Commercial Boulevard Parking,2019,Yes,4,0,4,9,In Favour
Permit Parking,2019,Yes,21,13,34,80,In Favour
Front Yard Parking,2019,Yes,22,0,22,55,In Favour
Front Yard Parking,2019,Yes,41,0,41,106,In Favour
Front Yard Parking,2019,Yes,9,3,12,31,In Favour
Traffic Calming,2019,Yes,52,8,60,122,In Favour
Traffic Calming,2019,No,8,4,12,58,Response Rate Not Met
Front Yard Parking,2019,Yes,42,0,42,80,In Favour
Traffic Calming,2019,Yes,33,3,36,44,In Favour
Traffic Calming,2019,Yes,14,17,31,59,Opposed
Front Yard Parking,2019,Yes,55,2,57,92,In Favour
Front Yard Parking,2019,Yes,20,1,21,36,In Favour
Boulevard Cafe,2019,No,9,12,21,148,Response Rate Not Met
Boulevard Cafe,2019,Yes,2,25,27,69,Opposed
Boulevard Cafe,2019,Yes,18,28,46,152,Opposed
Boulevard Cafe,2019,No,100,151,251,1878,Response Rate Not Met
Traffic Calming,2019,Yes,197,68,265,539,In Favour
Traffic Calming,2019,Yes,79,42,121,202,In Favour
Traffic Calming,2019,Yes,61,50,111,221,Opposed
Front Yard Parking,2019,Yes,9,2,11,19,In Favour
Front Yard Parking,2019,Yes,42,0,42,74,In Favour
Front Yard Parking,2019,Yes,40,10,50,105,In Favour
Front Yard Parking,2019,Yes,16,0,16,34,In Favour
Front Yard Parking,2019,Yes,19,4,23,47,In Favour
Boulevard Cafe,2019,Yes,23,16,39,137,In Favour
Traffic Calming,2019,No,81,22,103,369,Response Rate Not Met
Traffic Calming,2019,No,67,66,133,539,Response Rate Not Met
Front Yard Parking,2019,Yes,21,0,21,56,In Favour
Front Yard Parking,2019,Yes,45,4,49,79,In Favour
Front Yard Parking,2019,Yes,28,3,31,63,In Favour
Boulevard Cafe,2019,Yes,16,1,17,46,In Favour
Boulevard Cafe,2019,Yes,7,38,45,92,Opposed
Traffic Calming,2019,No,82,28,110,711,Response Rate Not Met
Front Yard Parking,2019,Yes,14,2,16,40,In Favour
Front Yard Parking,2019,Yes,27,6,33,52,In Favour
Permit Parking,2019,Yes,29,34,63,134,Opposed
Boulevard Cafe,2019,Yes,31,1,32,96,In Favour
Boulevard Cafe,2019,Yes,30,14,44,128,In Favour
Front Yard Parking,2019,Yes,41,6,47,101,In Favour
Front Yard Parking,2019,No,17,9,26,129,Response Rate Not Met
Front Yard Parking,2019,Yes,34,2,36,131,In Favour
Front Yard Parking,2019,Yes,30,5,35,62,In Favour
Traffic Calming,2019,No,15,11,26,96,Response Rate Not Met
Traffic Calming,2019,No,75,13,88,272,Response Rate Not Met
Front Yard Parking,2019,Yes,23,1,24,113,In Favour
Business Improvement Area,2019,Yes,16,1,17,56,In Favour
Front Yard Parking,2019,Yes,55,2,57,140,In Favour
Front Yard Parking,2019,Yes,25,5,30,68,In Favour
Front Yard Parking,2019,Yes,14,5,19,41,In Favour
Boulevard Cafe,2019,Yes,25,5,30,159,In Favour
Traffic Calming,2019,Yes,40,12,52,95,In Favour
Traffic Calming,2019,Yes,73,36,109,187,In Favour
Traffic Calming,2019,Yes,112,35,147,211,In Favour
Front Yard Parking,2019,Yes,48,5,53,155,In Favour
Permit Parking,2019,Yes,17,42,59,137,Opposed
Boulevard Cafe,2019,Yes,31,12,43,113,In Favour
Boulevard Cafe,2019,No,6,20,26,128,Response Rate Not Met
Boulevard Cafe,2019,Yes,15,3,18,67,In Favour
Front Yard Parking,2019,Yes,55,11,66,136,In Favour
Traffic Calming,2019,No,9,16,25,53,Response Rate Not Met
Front Yard Parking,2019,Yes,50,11,61,145,In Favour
Front Yard Parking,2019,Yes,25,3,28,63,In Favour
Front Yard Parking,2019,Yes,17,10,27,35,In Favour
Front Yard Parking,2019,Yes,31,0,31,60,In Favour
Front Yard Parking,2019,No,18,6,24,197,Response Rate Not Met
Front Yard Parking,2019,Yes,38,0,38,94,In Favour
Front Yard Parking,2019,Yes,30,13,43,102,In Favour
Traffic Calming,2019,Yes,60,13,73,167,In Favour
Commercial Boulevard Parking,2019,Yes,14,4,18,46,In Favour
Traffic Calming,2019,No,35,7,42,138,Response Rate Not Met
Traffic Calming,2019,No,53,13,66,204,Response Rate Not Met
Traffic Calming,2019,No,47,32,79,391,Response Rate Not Met
Permit Parking,2019,Yes,27,11,38,78,In Favour
Boulevard Cafe,2019,Yes,21,2,23,70,In Favour
Front Yard Parking,2019,Yes,11,1,12,20,In Favour
Front Yard Parking,2019,Yes,15,0,15,30,In Favour
Boulevard Cafe,2019,Yes,14,18,32,67,Opposed
Boulevard Cafe,2019,Yes,2,17,19,61,Opposed
Permit Parking,2019,Yes,7,4,11,48,In Favour
Front Yard Parking,2019,Yes,40,0,40,84,In Favour
Permit Parking,2019,Yes,7,0,7,22,In Favour
Permit Parking,2019,Yes,30,5,35,100,In Favour
Permit Parking,2019,Yes,0,0,0,2,Opposed
Permit Parking,2019,Yes,30,16,46,150,In Favour
Permit Parking,2019,Yes,13,8,21,45,In Favour
Permit Parking,2019,Yes,11,1,12,46,In Favour
Permit Parking,2019,Yes,17,10,27,59,In Favour
Permit Parking,2019,No,30,20,50,281,Response Rate Not Met
Boulevard Cafe,2019,Yes,24,2,26,47,In Favour
Boulevard Cafe,2019,Yes,8,21,29,126,Opposed
Permit Parking,2019,No,4,0,4,41,Response Rate Not Met
Permit Parking,2019,Yes,11,63,74,177,Opposed
Traffic Calming,2019,No,125,27,152,651,Response Rate Not Met
Front Yard Parking,2019,Yes,36,0,36,127,In Favour
Permit Parking,2019,Yes,18,13,31,68,In Favour
Boulevard Cafe,2019,Yes,7,11,18,27,Opposed
Front Yard Parking,2019,Yes,43,0,43,95,In Favour
Traffic Calming Safety Zone,2020,No,42,57,99,482,Response Rate Not Met
Traffic Calming,2019,Yes,64,14,78,138,In Favour
Traffic Calming,2019,No,37,7,44,235,Response Rate Not Met
Front Yard Parking,2019,Yes,54,3,57,99,In Favour
Boulevard Cafe,2019,Yes,8,14,22,95,Opposed
Traffic Calming,2019,No,46,6,52,141,Response Rate Not Met
Traffic Calming,2019,Yes,12,22,34,86,Opposed
Traffic Calming,2019,Yes,58,35,93,188,Opposed
Traffic Calming,2019,Yes,22,26,48,76,Opposed
Traffic Calming,2019,Yes,32,5,37,72,In Favour
Traffic Calming,2019,Yes,42,38,80,148,Opposed
Front Yard Parking,2019,Yes,13,0,13,35,In Favour
Front Yard Parking,2019,Yes,53,2,55,127,In Favour
Front Yard Parking,2019,Yes,33,0,33,62,In Favour
Boulevard Cafe,2019,Yes,13,1,14,60,In Favour
Traffic Calming,2019,Yes,51,5,56,115,In Favour
Traffic Calming,2019,Yes,54,14,68,132,In Favour
Front Yard Parking,2019,Yes,68,0,68,133,In Favour
Front Yard Parking,2019,Yes,18,7,25,57,In Favour
Permit Parking,2019,Yes,1,10,11,26,Opposed
Permit Parking,2019,Yes,37,12,49,96,In Favour
Traffic Calming,2019,No,24,0,24,74,Response Rate Not Met
Front Yard Parking,2019,Yes,34,6,40,106,In Favour
Front Yard Parking,2019,Yes,25,19,44,97,In Favour
Permit Parking,2019,Yes,24,19,43,127,In Favour
Appeal - Front Yard Parking,2020,Yes,19,4,23,51,In Favour
Permit Parking,2019,Yes,43,44,87,150,Opposed
Front Yard Parking,2020,Yes,40,4,44,78,In Favour
Front Yard Parking,2020,Yes,41,1,42,77,In Favour
Front Yard Parking,2020,Yes,14,1,15,85,In Favour
Front Yard Parking,2020,Yes,7,9,16,23,Opposed
Front Yard Parking,2020,Yes,7,9,16,23,Opposed
Business Improvement Area,2020,Yes,75,7,82,175,In Favour
Traffic Calming,2020,Yes,33,6,39,80,In Favour
Front Yard Parking,2020,Yes,32,1,33,56,In Favour
Front Yard Parking,2020,Yes,49,2,51,106,In Favour
Permit Parking,2020,Yes,42,32,74,141,In Favour
Traffic Calming Safety Zone,2020,Yes,12,5,17,43,In Favour
Permit Parking,2020,Yes,0,13,13,36,Opposed
Front Yard Parking,2020,Yes,40,5,45,107,In Favour
Permit Parking,2020,Yes,21,9,30,130,In Favour
Traffic Calming Safety Zone,2020,Yes,80,33,113,376,In Favour
Traffic Calming,2020,Yes,32,6,38,72,In Favour
Front Yard Parking,2020,Yes,35,4,39,113,In Favour
Front Yard Parking,2020,Yes,29,4,33,96,In Favour
Front Yard Parking,2020,Yes,27,8,35,41,In Favour
Front Yard Parking,2020,Yes,33,1,34,99,In Favour
Permit Parking,2020,Yes,2,16,18,52,Opposed
Permit Parking,2020,Yes,32,31,63,114,Opposed
Front Yard Parking,2020,Yes,25,11,36,91,In Favour
Front Yard Parking,2020,Yes,27,12,39,104,In Favour
Front Yard Parking,2020,Yes,7,0,7,30,In Favour
Permit Parking Removal,2020,Yes,14,33,47,166,Opposed
Permit Parking Removal,2020,Yes,10,12,22,72,Opposed
Permit Parking Removal,2020,Yes,11,27,38,65,Opposed
Permit Parking Removal,2020,Yes,14,7,21,63,In Favour
Permit Parking Removal,2020,No,11,0,11,105,Response Rate Not Met
Permit Parking Removal,2020,Yes,7,15,22,41,Opposed
Front Yard Parking,2020,Yes,41,10,51,97,In Favour
Permit Parking Removal,2020,Yes,165,40,205,539,In Favour
Permit Parking Removal,2021,Yes,12,1,13,72,In Favour
Permit Parking Removal,2021,Yes,7,1,8,31,In Favour
Permit Parking Removal,2021,No,33,15,48,458,Response Rate Not Met
Permit Parking Removal,2021,Yes,65,22,87,216,In Favour
Permit Parking Removal,2020,Yes,8,6,14,53,Opposed
Permit Parking Removal,2020,Yes,10,5,15,48,In Favour
Permit Parking Removal,2020,Yes,42,33,75,192,Opposed
Permit Parking Removal,2020,Yes,20,22,42,105,Opposed
Permit Parking Removal,2020,Yes,20,16,36,83,Opposed
Permit Parking Removal,2021,Yes,16,6,22,70,In Favour
Permit Parking Removal,2021,Yes,32,8,40,71,In Favour
Permit Parking Removal,2021,Yes,5,9,14,32,Opposed
Permit Parking Removal,2021,Yes,6,11,17,26,Opposed
Permit Parking Removal,2021,Yes,57,27,84,187,In Favour
Permit Parking Removal,2021,No,8,1,9,53,Response Rate Not Met
Permit Parking Removal,2021,Yes,15,6,21,61,In Favour
Permit Parking Removal,2021,Yes,57,20,77,192,In Favour
Permit Parking Removal,2021,Yes,2,1,3,5,Opposed
Permit Parking Removal,2021,Yes,55,23,78,192,In Favour
Permit Parking,2020,No,77,44,121,577,Response Rate Not Met
Traffic Calming,2020,No,47,49,96,220,Response Rate Not Met
Front Yard Parking,2020,Yes,58,6,64,106,In Favour
Front Yard Parking,2020,Yes,42,2,44,77,In Favour
Front Yard Parking,2020,Yes,27,25,52,106,Opposed
Traffic Calming,2020,No,150,9,159,679,Response Rate Not Met
Traffic Calming,2020,No,40,6,46,135,Response Rate Not Met
Traffic Calming,2020,No,30,5,35,107,Response Rate Not Met
Traffic Calming,2020,Yes,28,2,30,44,In Favour
Traffic Calming,2020,Yes,95,23,118,186,In Favour
Business Improvement Area,2020,No,0,0,0,999,Response Rate Not Met
Proposed Business Improvement Area,2020,No,1,0,1,245,Response Rate Not Met
Proposed Business Improvement Area,2020,No,0,0,0,23,Response Rate Not Met
Front Yard Parking,2020,Yes,53,0,53,104,In Favour
Front Yard Parking,2020,Yes,28,3,31,91,In Favour
Permit Parking Removal,2020,Yes,24,68,92,170,Opposed
Permit Parking Removal,2020,Yes,10,35,45,75,Opposed
Permit Parking Removal,2020,Yes,8,34,42,65,Opposed
Permit Parking Removal,2020,Yes,9,54,63,106,Opposed
Permit Parking Removal,2020,Yes,1,16,17,42,Opposed
Permit Parking,2020,Yes,5,3,8,15,In Favour
Permit Parking,2020,Yes,13,0,13,32,In Favour
Traffic Calming,2020,No,8,12,20,61,Response Rate Not Met
Traffic Calming,2020,No,85,7,92,258,Response Rate Not Met
Front Yard Parking,2020,Yes,64,0,64,103,In Favour
Front Yard Parking,2020,Yes,50,5,55,129,In Favour
Traffic Calming,2020,Yes,29,12,41,99,Opposed
Traffic Calming Safety Zone,2020,Yes,135,42,177,645,In Favour
Traffic Calming,2020,No,30,5,35,83,Response Rate Not Met
Permit Parking,2020,Yes,25,9,34,113,In Favour
Traffic Calming,2020,No,29,7,36,179,Response Rate Not Met
Front Yard Parking,2020,Yes,35,0,35,62,In Favour
Permit Parking,2020,Yes,8,22,30,45,Opposed
Front Yard Parking,2020,Yes,63,1,64,104,In Favour
Permit Parking,2020,Yes,19,12,31,73,In Favour
Front Yard Parking,2020,Yes,30,0,30,50,In Favour
Front Yard Parking,2020,Yes,60,2,62,88,In Favour
Permit Parking,2021,Yes,1,2,3,11,Opposed
Front Yard Parking,2021,Yes,45,10,55,96,In Favour
Front Yard Parking,2021,Yes,20,1,21,72,In Favour
Front Yard Parking,2021,Yes,37,5,42,98,In Favour
Front Yard Parking,2021,Yes,45,3,48,193,In Favour
Permit Parking,2021,Yes,61,37,98,301,In Favour
Traffic Calming – Island,2021,No,38,33,71,173,Response Rate Not Met
Traffic Calming – Island,2021,Yes,22,9,31,58,In Favour
Front Yard Parking,2021,Yes,30,0,30,88,In Favour
Permit Parking Removal,2021,Yes,18,9,27,70,In Favour
Permit Parking,2021,Yes,0,4,4,33,Opposed
Traffic Calming,2021,No,124,64,188,584,Response Rate Not Met
Commercial Boulevard Parking,2021,Yes,6,10,16,50,Opposed
Front Yard Parking,2021,Yes,38,5,43,109,In Favour
Front Yard Parking,2021,Yes,21,1,22,46,In Favour
Front Yard Parking,2021,Yes,42,11,53,97,In Favour
Front Yard Parking,2021,Yes,23,6,29,49,In Favour
Permit Parking,2021,Yes,80,39,119,400,In Favour
Front Yard Parking,2021,Yes,33,6,39,88,In Favour
Front Yard Parking,2021,Yes,32,0,32,57,In Favour
Front Yard Parking,2021,Yes,30,13,43,102,In Favour
Traffic Calming,2021,No,37,5,42,86,Response Rate Not Met
Front Yard Parking,2021,Yes,54,4,58,103,In Favour
Front Yard Parking,2021,Yes,18,4,22,105,In Favour
Permit Parking,2021,Yes,25,45,70,195,Opposed
Front Yard Parking,2021,Yes,63,2,65,155,In Favour
Traffic Calming,2021,Yes,110,8,118,240,In Favour
Front Yard Parking,2021,Yes,54,2,56,110,In Favour
Front Yard Parking,2021,No,18,2,20,85,Response Rate Not Met
Front Yard Parking,2021,No,9,4,13,62,Response Rate Not Met
Front Yard Parking,2021,Yes,35,4,39,70,In Favour
Permit Parking,2021,Yes,13,18,31,94,Opposed
Commercial Boulevard Parking,2021,Yes,2,12,14,37,Opposed
Front Yard Parking,2021,No,5,2,7,45,Response Rate Not Met
Front Yard Parking,2021,Yes,32,0,32,91,In Favour
Front Yard Parking,2021,Yes,31,1,32,76,In Favour
Front Yard Parking,2021,Yes,17,0,17,18,In Favour
Front Yard Parking,2021,Yes,8,0,8,10,In Favour
Proposed Business Improvement Area,2021,No,25,11,36,258,Response Rate Not Met
Permit Parking Removal,2021,Yes,20,42,62,81,Opposed
Front Yard Parking,2021,Yes,36,3,39,75,In Favour
Front Yard Parking,2021,Yes,37,0,37,101,In Favour
Front Yard Parking,2021,Yes,7,0,7,31,In Favour
Front Yard Parking,2021,Yes,35,0,35,113,In Favour
Front Yard Parking,2021,Yes,52,7,59,108,In Favour
Front Yard Parking,2021,Yes,54,4,58,114,In Favour
Front Yard Parking,2021,Yes,71,0,71,110,In Favour
Permit Parking,2021,Yes,40,3,43,120,In Favour
Front Yard Parking,2021,Yes,9,0,9,20,In Favour
Front Yard Parking,2021,Yes,33,0,33,68,In Favour
Front Yard Parking,2021,Yes,22,0,22,99,In Favour
Front Yard Parking,2021,Yes,14,0,14,35,In Favour
Front Yard Parking,2021,Yes,41,2,43,92,In Favour
Front Yard Parking,2021,Yes,22,9,31,134,In Favour
Front Yard Parking,2021,Yes,50,4,54,101,In Favour
Traffic Calming,2021,No,65,31,96,256,Response Rate Not Met
Front Yard Parking,2021,Yes,28,2,30,49,In Favour
Front Yard Parking,2021,Yes,14,0,14,46,In Favour
Front Yard Parking,2021,Yes,26,0,26,61,In Favour
Front Yard Parking,2021,Yes,47,2,49,94,In Favour
Front Yard Parking,2021,Yes,18,1,19,75,In Favour
Front Yard Parking,2021,Yes,24,0,24,66,In Favour
Traffic Calming Safety Zone,2021,Yes,50,14,64,260,In Favour
Traffic Calming,2021,No,67,58,125,306,Response Rate Not Met
Traffic Calming,2021,No,28,1,29,116,Response Rate Not Met
Traffic Calming,2021,No,29,16,45,165,Response Rate Not Met
Traffic Calming Safety Zone,2021,Yes,29,15,44,101,In Favour
Permit Parking,2021,Yes,22,13,35,97,In Favour
Permit Parking,2021,No,35,11,46,323,Response Rate Not Met
Front Yard Parking,2021,Yes,63,1,64,97,In Favour
Front Yard Parking,2021,Yes,39,0,39,79,In Favour
Front Yard Parking,2021,Yes,34,2,36,68,In Favour
Front Yard Parking,2021,Yes,43,2,45,80,In Favour
Front Yard Parking,2021,Yes,13,2,15,43,In Favour
Permit Parking,2021,Yes,2,18,20,64,Opposed
Front Yard Parking,2021,Yes,17,0,17,45,In Favour
Permit Parking,2021,Yes,3,10,13,61,Opposed
Front Yard Parking,2021,Yes,23,5,28,88,In Favour
Front Yard Parking,2021,Yes,32,0,32,72,In Favour
Permit Parking,2021,Yes,22,16,38,76,In Favour
Permit Parking,2021,Yes,16,10,26,60,In Favour
Front Yard Parking,2021,Yes,27,12,39,80,In Favour
Front Yard Parking,2021,Yes,32,6,38,136,In Favour
Front Yard Parking,2021,Yes,25,1,26,59,In Favour
Front Yard Parking,2021,Yes,41,2,43,88,In Favour
Front Yard Parking,2021,Yes,37,0,37,45,In Favour
Traffic Calming,2021,No,29,1,30,105,Response Rate Not Met
Front Yard Parking,2021,Yes,17,0,17,27,In Favour
Front Yard Parking,2021,Yes,33,0,33,75,In Favour
Front Yard Parking,2021,Yes,15,6,21,41,In Favour
Front Yard Parking,2021,Yes,55,4,59,107,In Favour
Front Yard Parking,2021,Yes,36,0,36,76,In Favour
Front Yard Parking,2021,Yes,72,3,75,90,In Favour
Front Yard Parking,2021,Yes,10,0,10,23,In Favour
Front Yard Parking,2021,Yes,42,5,47,95,In Favour
Front Yard Parking,2021,Yes,26,4,30,129,In Favour
Front Yard Parking,2021,Yes,25,0,25,81,In Favour
Front Yard Parking,2022,No,14,2,16,81,Response Rate Not Met
Front Yard Parking,2022,Yes,34,5,39,117,In Favour
Front Yard Parking,2022,Yes,23,3,26,44,In Favour
Front Yard Parking,2022,Yes,49,0,49,92,In Favour
Front Yard Parking,2022,Yes,34,15,49,112,In Favour
Front Yard Parking,2022,Yes,37,0,37,52,In Favour
Front Yard Parking,2022,Yes,40,2,42,126,In Favour
Commercial Boulevard Parking,2022,No,2,3,5,45,Response Rate Not Met
Permit Parking,2022,Yes,0,6,6,11,Opposed
Permit Parking,2022,Yes,33,57,90,151,Opposed
Front Yard Parking,2022,Yes,32,0,32,61,In Favour
Traffic Calming,2022,Yes,41,5,46,75,In Favour
Traffic Calming,2022,Yes,17,0,17,22,In Favour
Front Yard Parking,2022,Yes,26,1,27,64,In Favour
Permit Parking,2022,No,10,5,15,66,Response Rate Not Met
Front Yard Parking,2022,Yes,77,1,78,133,In Favour
Front Yard Parking,2022,Yes,10,0,10,34,In Favour
Front Yard Parking,2022,Yes,47,15,62,111,In Favour
Permit Parking,2022,Yes,29,3,32,104,In Favour
Permit Parking,2022,Yes,20,7,27,100,In Favour
Front Yard Parking,2022,Yes,64,2,66,105,In Favour
Front Yard Parking,2022,Yes,37,1,38,82,In Favour
Front Yard Parking,2022,Yes,31,5,36,140,In Favour
Front Yard Parking,2022,Yes,30,2,32,57,In Favour
Front Yard Parking,2022,Yes,42,8,50,115,In Favour
Front Yard Parking,2022,Yes,36,0,36,71,In Favour
Front Yard Parking,2022,Yes,20,4,24,30,In Favour
Permit Parking,2022,Yes,17,16,33,72,Opposed
Front Yard Parking,2022,Yes,28,9,37,63,In Favour
Front Yard Parking,2022,Yes,41,1,42,86,In Favour
Front Yard Parking,2022,Yes,22,1,23,75,In Favour
Permit Parking,2022,Yes,26,19,45,117,In Favour
Front Yard Parking,2022,Yes,44,0,44,98,In Favour
Front Yard Parking,2022,Yes,32,11,43,89,In Favour
Front Yard Parking,2022,Yes,41,0,41,79,In Favour
Front Yard Parking,2022,Yes,66,10,76,124,In Favour
Front Yard Parking,2022,Yes,27,1,28,42,In Favour
Front Yard Parking,2022,Yes,13,0,13,21,In Favour
Front Yard Parking,2022,Yes,27,5,32,64,In Favour
Front Yard Parking,2022,Yes,29,4,33,52,In Favour
Permit Parking,2022,Yes,15,0,15,63,In Favour
Permit Parking,2022,Yes,4,34,38,86,Opposed
Front Yard Parking,2022,Yes,18,0,18,52,In Favour
Permit Parking,2022,Yes,11,9,20,72,Opposed
Front Yard Parking,2022,Yes,17,0,17,55,In Favour
Front Yard Parking,2022,Yes,15,5,20,92,In Favour
Front Yard Parking,2022,Yes,20,0,20,55,In Favour
Permit Parking,2022,Yes,5,36,41,118,Opposed
Permit Parking,2022,Yes,4,16,20,72,Opposed
Permit Parking,2022,Yes,4,24,28,52,Opposed
Traffic Calming Safety Zone,2022,Yes,39,21,60,125,In Favour
Traffic Calming,2022,Yes,70,25,95,151,In Favour
Traffic Calming,2022,Yes,7,16,23,75,Opposed
Traffic Calming,2022,No,41,8,49,156,Response Rate Not Met
Front Yard Parking,2022,Yes,58,3,61,135,In Favour
Traffic Calming,2022,Yes,36,1,37,112,In Favour
Front Yard Parking,2022,Yes,68,0,68,119,In Favour
Front Yard Parking,2022,Yes,44,13,57,89,In Favour
Front Yard Parking,2022,No,10,0,10,73,Response Rate Not Met
Front Yard Parking,2022,Yes,20,1,21,40,In Favour
Permit Parking,2022,Yes,31,107,138,408,Opposed
Traffic Calming,2022,No,29,1,30,65,Response Rate Not Met
Traffic Calming,2022,No,41,57,98,215,Response Rate Not Met
Front Yard Parking,2022,Yes,50,12,62,99,In Favour
Traffic Calming,2022,Yes,16,2,18,30,In Favour
Traffic Calming,2022,No,21,12,33,158,Response Rate Not Met
Traffic Calming,2022,No,54,2,56,198,Response Rate Not Met
Front Yard Parking,2022,Yes,27,1,28,99,In Favour
Front Yard Parking,2022,Yes,11,4,15,49,In Favour
Front Yard Parking,2022,Yes,35,6,41,94,In Favour
Front Yard Parking,2022,Yes,43,0,43,50,In Favour
Traffic Calming Safety Zone,2022,Yes,91,27,118,313,In Favour
Front Yard Parking,2022,Yes,39,4,43,76,In Favour
Permit Parking,2022,Yes,3,2,5,10,Opposed
Front Yard Parking,2022,Yes,11,4,15,26,In Favour
Front Yard Parking,2022,Yes,23,2,25,69,In Favour
Front Yard Parking,2022,Yes,7,0,7,34,In Favour
Front Yard Parking,2022,Yes,52,4,56,100,In Favour
Permit Parking,2022,Yes,15,17,32,58,Opposed
Front Yard Parking,2022,Yes,9,0,9,37,In Favour
Front Yard Parking,2022,Yes,39,0,39,73,In Favour
Front Yard Parking,2022,Yes,48,0,48,74,In Favour
Front Yard Parking,2022,Yes,38,0,38,82,In Favour
Front Yard Parking,2023,Yes,19,4,23,45,In Favour
Front Yard Parking,2023,Yes,8,1,9,19,In Favour
Traffic Calming Safety Zone,2023,Yes,86,26,112,227,In Favour
Traffic Calming,2023,No,56,38,94,242,Response Rate Not Met
Front Yard Parking,2023,Yes,11,16,27,79,Opposed
Front Yard Parking,2023,Yes,36,0,36,82,In Favour
Front Yard Parking,2023,Yes,56,1,57,87,In Favour
Front Yard Parking,2023,Yes,72,0,72,115,In Favour
Front Yard Parking,2023,Yes,27,0,27,70,In Favour
Front Yard Parking,2023,Yes,15,5,20,52,In Favour
Front Yard Parking,2023,Yes,21,0,21,39,In Favour
Front Yard Parking,2023,Yes,25,0,25,45,In Favour
Traffic Calming,2022,Yes,29,8,37,74,In Favour
Permit Parking,2023,Yes,20,8,28,73,In Favour
Front Yard Parking,2023,Yes,20,0,20,75,In Favour
Front Yard Parking,2023,Yes,23,1,24,97,In Favour
Front Yard Parking,2023,Yes,37,3,40,107,In Favour
Traffic Calming,2023,No,24,4,28,63,Response Rate Not Met
Traffic Calming,2023,No,56,15,71,225,Response Rate Not Met
Front Yard Parking,2023,Yes,8,0,8,21,In Favour
Front Yard Parking,2023,Yes,28,0,28,95,In Favour
Front Yard Parking,2023,Yes,17,6,23,32,In Favour
Front Yard Parking,2023,Yes,59,2,61,119,In Favour
Front Yard Parking,2023,Yes,30,11,41,65,In Favour
Front Yard Parking,2023,Yes,33,0,33,76,In Favour
Front Yard Parking,2023,Yes,37,27,64,161,In Favour
Front Yard Parking,2023,Yes,33,9,42,85,In Favour
Front Yard Parking,2023,Yes,29,0,29,80,In Favour
Front Yard Parking,2023,Yes,25,3,28,90,In Favour
Front Yard Parking,2023,Yes,43,3,46,98,In Favour
Front Yard Parking,2023,Yes,22,0,22,42,In Favour
Front Yard Parking,2023,Yes,19,0,19,25,In Favour
Front Yard Parking,2023,Yes,61,0,61,107,In Favour
Front Yard Parking,2023,Yes,27,6,33,94,In Favour
Front Yard Parking,2023,Yes,51,4,55,103,In Favour
Front Yard Parking,2023,Yes,30,0,30,51,In Favour
Front Yard Parking,2023,Yes,37,0,37,68,In Favour
Front Yard Parking,2023,Yes,25,2,27,110,In Favour
Traffic Calming,2023,Yes,32,4,36,68,In Favour
Traffic Calming,2023,Yes,19,21,40,70,Opposed
Traffic Calming,2023,No,66,33,99,261,Response Rate Not Met
Front Yard Parking,2023,Yes,19,9,28,64,In Favour
Front Yard Parking,2023,Yes,52,1,53,118,In Favour
Front Yard Parking,2023,Yes,26,1,27,133,In Favour
Front Yard Parking,2023,Yes,32,3,35,62,In Favour
Traffic Calming,2023,No,27,53,80,228,Response Rate Not Met
Front Yard Parking,2023,Yes,25,1,26,55,In Favour
Front Yard Parking,2023,No,4,2,6,65,Response Rate Not Met
Front Yard Parking,2023,Yes,28,9,37,107,In Favour
Permit Parking,2023,Yes,19,4,23,78,In Favour
Front Yard Parking,2023,Yes,33,1,34,88,In Favour
Front Yard Parking,2023,Yes,22,2,24,51,In Favour
Permit Parking,2023,Yes,19,13,32,153,Opposed
Front Yard Parking,2023,Yes,50,0,50,113,In Favour
Front Yard Parking,2023,Yes,29,0,29,62,In Favour
Traffic Calming,2023,Yes,53,15,68,124,In Favour
Traffic Calming,2023,No,12,9,21,102,Response Rate Not Met
Traffic Calming,2023,No,37,5,42,151,Response Rate Not Met
Front Yard Parking,2023,Yes,17,12,29,32,In Favour
Front Yard Parking,2023,Yes,77,0,77,139,In Favour
Front Yard Parking,2023,Yes,37,4,41,102,In Favour
Permit Parking,2023,Yes,50,16,66,117,In Favour
Front Yard Parking,2023,Yes,22,0,22,69,In Favour
Front Yard Parking,2023,Yes,23,6,29,88,In Favour
Front Yard Parking,2023,Yes,19,0,19,41,In Favour
Front Yard Parking,2023,Yes,16,0,16,61,In Favour
Front Yard Parking,2023,Yes,17,0,17,36,In Favour
Front Yard Parking,2023,Yes,60,2,62,118,In Favour
Front Yard Parking,2023,Yes,32,4,36,64,In Favour
Front Yard Parking,2023,Yes,19,1,20,50,In Favour
Front Yard Parking,2023,Yes,26,4,30,72,In Favour
Front Yard Parking,2023,Yes,24,10,34,119,In Favour
Front Yard Parking,2023,Yes,31,1,32,41,In Favour
Front Yard Parking,2023,Yes,34,25,59,107,Opposed
Front Yard Parking,2023,Yes,34,0,34,82,In Favour
Front Yard Parking,2023,Yes,25,0,25,61,In Favour
Front Yard Parking,2023,Yes,34,0,34,40,In Favour
Front Yard Parking,2023,Yes,10,0,10,29,In Favour
Front Yard Parking,2023,Yes,26,5,31,60,In Favour
Front Yard Parking,2023,No,26,2,28,139,Response Rate Not Met
Permit Parking,2023,No,7,6,13,58,Response Rate Not Met
Front Yard Parking,2023,Yes,27,2,29,59,In Favour
Front Yard Parking,2023,Yes,30,2,32,80,In Favour
Front Yard Parking,2023,Yes,1,28,29,63,Opposed
Front Yard Parking,2023,Yes,22,0,22,43,In Favour
Front Yard Parking,2023,Yes,20,0,20,41,In Favour
Front Yard Parking,2023,Yes,17,2,19,48,In Favour
Front Yard Parking,2023,Yes,41,0,41,87,In Favour
Front Yard Parking,2023,Yes,28,0,28,46,In Favour
Permit Parking,2023,Yes,39,41,80,167,Opposed
Permit Parking,2023,Yes,43,8,51,100,In Favour
Permit Parking,2023,Yes,23,33,56,209,Opposed
Front Yard Parking,2023,Yes,48,1,49,136,In Favour
Front Yard Parking,2023,Yes,42,0,42,72,In Favour
Traffic Calming,2023,Yes,31,1,32,70,In Favour
Traffic Calming,2023,No,7,10,17,64,Response Rate Not Met
Front Yard Parking,2023,Yes,37,2,39,51,In Favour
Front Yard Parking,2023,Yes,3,0,3,7,In Favour
Front Yard Parking,2024,Yes,64,1,65,142,In Favour
Permit Parking,2024,Yes,15,37,52,144,Opposed
Front Yard Parking,2024,Yes,37,8,45,82,In Favour
Front Yard Parking,2024,Yes,5,2,7,14,Opposed
